XXXXXXXXXX
XOO#XOOOOX
XOOXXXXOOX
XXOXOOOOXX
XOOXXXXOXX
XOOOOOOOOX
XOXXXXOXXX
XOXOXOOOOX
XOOOOOOOOX
XOOOSXOOOX
XXXXXXXXXX